{
    "tiles": {
        "1":  {
            "movable": true,
            "path": "assets/grass.png"
        }
    },
    "objects": {
        "1": {
            "movable": false,
            "interactive": false,
            "rowSpan": 1,
            "columnSpan": 1,
            "visuals": {
                "idle": {
                    "frames": [
                        { "path": "assets/vox/arbol_1.png" }
                    ] 
                }
            }
        },
        "2": {
            "movable": false,
            "interactive": false,
            "rowSpan": 1,
            "columnSpan": 1,
            "visuals": {
                "idle": {
                    "frames": [
                        { "path": "assets/vox/arbol_2.png" }
                    ] 
                }
            }
        },
        "3": {
            "movable": false,
            "interactive": false,
            "rowSpan": 1,
            "columnSpan": 1,
            "visuals": {
                "idle": {
                    "frames": [
                        { "path": "assets/vox/arbol_3.png" }
                    ] 
                }
            }
        },
        "4": {
            "movable": false,
            "interactive": false,
            "rowSpan": 1,
            "columnSpan": 1,
            "visuals": {
                "idle": {
                    "frames": [
                        { "path": "assets/vox/arbol_4.png" }
                    ] 
                }
            }
        },
        "5": {
            "movable": false,
            "interactive": false,
            "rowSpan": 1,
            "columnSpan": 1,
            "visuals": {
                "idle": {
                    "frames": [
                        { "path": "assets/vox/arbol_5.png" }
                    ] 
                }
            }
        }
    },
    "groundMap": [
        { "row": "1 ,1 ,1 ,1, 1 ,1 ,1 ,1, 1 ,1 ,1 ,1, 1 ,1 ,1 ,1, 1 ,1 ,1 ,1, 1 ,1 ,1 ,1, 1 ,1 ,1 ,1, 1 ,1 ,1 ,1" },
        { "row": "1 ,1 ,1 ,1, 1 ,1 ,1 ,1, 1 ,1 ,1 ,1, 1 ,1 ,1 ,1, 1 ,1 ,1 ,1, 1 ,1 ,1 ,1, 1 ,1 ,1 ,1, 1 ,1 ,1 ,1" },
        { "row": "1 ,1 ,1 ,1, 1 ,1 ,1 ,1, 1 ,1 ,1 ,1, 1 ,1 ,1 ,1, 1 ,1 ,1 ,1, 1 ,1 ,1 ,1, 1 ,1 ,1 ,1, 1 ,1 ,1 ,1" },
        { "row": "1 ,1 ,1 ,1, 1 ,1 ,1 ,1, 1 ,1 ,1 ,1, 1 ,1 ,1 ,1, 1 ,1 ,1 ,1, 1 ,1 ,1 ,1, 1 ,1 ,1 ,1, 1 ,1 ,1 ,1" },
        { "row": "1 ,1 ,1 ,1, 1 ,1 ,1 ,1, 1 ,1 ,1 ,1, 1 ,1 ,1 ,1, 1 ,1 ,1 ,1, 1 ,1 ,1 ,1, 1 ,1 ,1 ,1, 1 ,1 ,1 ,1" },
        { "row": "1 ,1 ,1 ,1, 1 ,1 ,1 ,1, 1 ,1 ,1 ,1, 1 ,1 ,1 ,1, 1 ,1 ,1 ,1, 1 ,1 ,1 ,1, 1 ,1 ,1 ,1, 1 ,1 ,1 ,1" },
        { "row": "1 ,1 ,1 ,1, 1 ,1 ,1 ,1, 1 ,1 ,1 ,1, 1 ,1 ,1 ,1, 1 ,1 ,1 ,1, 1 ,1 ,1 ,1, 1 ,1 ,1 ,1, 1 ,1 ,1 ,1" },
        { "row": "1 ,1 ,1 ,1, 1 ,1 ,1 ,1, 1 ,1 ,1 ,1, 1 ,1 ,1 ,1, 1 ,1 ,1 ,1, 1 ,1 ,1 ,1, 1 ,1 ,1 ,1, 1 ,1 ,1 ,1" },
        { "row": "1 ,1 ,1 ,1, 1 ,1 ,1 ,1, 1 ,1 ,1 ,1, 1 ,1 ,1 ,1, 1 ,1 ,1 ,1, 1 ,1 ,1 ,1, 1 ,1 ,1 ,1, 1 ,1 ,1 ,1" },
        { "row": "1 ,1 ,1 ,1, 1 ,1 ,1 ,1, 1 ,1 ,1 ,1, 1 ,1 ,1 ,1, 1 ,1 ,1 ,1, 1 ,1 ,1 ,1, 1 ,1 ,1 ,1, 1 ,1 ,1 ,1" },
        { "row": "1 ,1 ,1 ,1, 1 ,1 ,1 ,1, 1 ,1 ,1 ,1, 1 ,1 ,1 ,1, 1 ,1 ,1 ,1, 1 ,1 ,1 ,1, 1 ,1 ,1 ,1, 1 ,1 ,1 ,1" },
        { "row": "1 ,1 ,1 ,1, 1 ,1 ,1 ,1, 1 ,1 ,1 ,1, 1 ,1 ,1 ,1, 1 ,1 ,1 ,1, 1 ,1 ,1 ,1, 1 ,1 ,1 ,1, 1 ,1 ,1 ,1" },
        { "row": "1 ,1 ,1 ,1, 1 ,1 ,1 ,1, 1 ,1 ,1 ,1, 1 ,1 ,1 ,1, 1 ,1 ,1 ,1, 1 ,1 ,1 ,1, 1 ,1 ,1 ,1, 1 ,1 ,1 ,1" },
        { "row": "1 ,1 ,1 ,1, 1 ,1 ,1 ,1, 1 ,1 ,1 ,1, 1 ,1 ,1 ,1, 1 ,1 ,1 ,1, 1 ,1 ,1 ,1, 1 ,1 ,1 ,1, 1 ,1 ,1 ,1" },
        { "row": "1 ,1 ,1 ,1, 1 ,1 ,1 ,1, 1 ,1 ,1 ,1, 1 ,1 ,1 ,1, 1 ,1 ,1 ,1, 1 ,1 ,1 ,1, 1 ,1 ,1 ,1, 1 ,1 ,1 ,1" },
        { "row": "1 ,1 ,1 ,1, 1 ,1 ,1 ,1, 1 ,1 ,1 ,1, 1 ,1 ,1 ,1, 1 ,1 ,1 ,1, 1 ,1 ,1 ,1, 1 ,1 ,1 ,1, 1 ,1 ,1 ,1" },
        { "row": "1 ,1 ,1 ,1, 1 ,1 ,1 ,1, 1 ,1 ,1 ,1, 1 ,1 ,1 ,1, 1 ,1 ,1 ,1, 1 ,1 ,1 ,1, 1 ,1 ,1 ,1, 1 ,1 ,1 ,1" },
        { "row": "1 ,1 ,1 ,1, 1 ,1 ,1 ,1, 1 ,1 ,1 ,1, 1 ,1 ,1 ,1, 1 ,1 ,1 ,1, 1 ,1 ,1 ,1, 1 ,1 ,1 ,1, 1 ,1 ,1 ,1" },
        { "row": "1 ,1 ,1 ,1, 1 ,1 ,1 ,1, 1 ,1 ,1 ,1, 1 ,1 ,1 ,1, 1 ,1 ,1 ,1, 1 ,1 ,1 ,1, 1 ,1 ,1 ,1, 1 ,1 ,1 ,1" },
        { "row": "1 ,1 ,1 ,1, 1 ,1 ,1 ,1, 1 ,1 ,1 ,1, 1 ,1 ,1 ,1, 1 ,1 ,1 ,1, 1 ,1 ,1 ,1, 1 ,1 ,1 ,1, 1 ,1 ,1 ,1" },
        { "row": "1 ,1 ,1 ,1, 1 ,1 ,1 ,1, 1 ,1 ,1 ,1, 1 ,1 ,1 ,1, 1 ,1 ,1 ,1, 1 ,1 ,1 ,1, 1 ,1 ,1 ,1, 1 ,1 ,1 ,1" },
        { "row": "1 ,1 ,1 ,1, 1 ,1 ,1 ,1, 1 ,1 ,1 ,1, 1 ,1 ,1 ,1, 1 ,1 ,1 ,1, 1 ,1 ,1 ,1, 1 ,1 ,1 ,1, 1 ,1 ,1 ,1" },
        { "row": "1 ,1 ,1 ,1, 1 ,1 ,1 ,1, 1 ,1 ,1 ,1, 1 ,1 ,1 ,1, 1 ,1 ,1 ,1, 1 ,1 ,1 ,1, 1 ,1 ,1 ,1, 1 ,1 ,1 ,1" },
        { "row": "1 ,1 ,1 ,1, 1 ,1 ,1 ,1, 1 ,1 ,1 ,1, 1 ,1 ,1 ,1, 1 ,1 ,1 ,1, 1 ,1 ,1 ,1, 1 ,1 ,1 ,1, 1 ,1 ,1 ,1" },
        { "row": "1 ,1 ,1 ,1, 1 ,1 ,1 ,1, 1 ,1 ,1 ,1, 1 ,1 ,1 ,1, 1 ,1 ,1 ,1, 1 ,1 ,1 ,1, 1 ,1 ,1 ,1, 1 ,1 ,1 ,1" },
        { "row": "1 ,1 ,1 ,1, 1 ,1 ,1 ,1, 1 ,1 ,1 ,1, 1 ,1 ,1 ,1, 1 ,1 ,1 ,1, 1 ,1 ,1 ,1, 1 ,1 ,1 ,1, 1 ,1 ,1 ,1" },
        { "row": "1 ,1 ,1 ,1, 1 ,1 ,1 ,1, 1 ,1 ,1 ,1, 1 ,1 ,1 ,1, 1 ,1 ,1 ,1, 1 ,1 ,1 ,1, 1 ,1 ,1 ,1, 1 ,1 ,1 ,1" },
        { "row": "1 ,1 ,1 ,1, 1 ,1 ,1 ,1, 1 ,1 ,1 ,1, 1 ,1 ,1 ,1, 1 ,1 ,1 ,1, 1 ,1 ,1 ,1, 1 ,1 ,1 ,1, 1 ,1 ,1 ,1" },
        { "row": "1 ,1 ,1 ,1, 1 ,1 ,1 ,1, 1 ,1 ,1 ,1, 1 ,1 ,1 ,1, 1 ,1 ,1 ,1, 1 ,1 ,1 ,1, 1 ,1 ,1 ,1, 1 ,1 ,1 ,1" },
        { "row": "1 ,1 ,1 ,1, 1 ,1 ,1 ,1, 1 ,1 ,1 ,1, 1 ,1 ,1 ,1, 1 ,1 ,1 ,1, 1 ,1 ,1 ,1, 1 ,1 ,1 ,1, 1 ,1 ,1 ,1" },
        { "row": "1 ,1 ,1 ,1, 1 ,1 ,1 ,1, 1 ,1 ,1 ,1, 1 ,1 ,1 ,1, 1 ,1 ,1 ,1, 1 ,1 ,1 ,1, 1 ,1 ,1 ,1, 1 ,1 ,1 ,1" },
        { "row": "1 ,1 ,1 ,1, 1 ,1 ,1 ,1, 1 ,1 ,1 ,1, 1 ,1 ,1 ,1, 1 ,1 ,1 ,1, 1 ,1 ,1 ,1, 1 ,1 ,1 ,1, 1 ,1 ,1 ,1" },
        { "row": "1 ,1 ,1 ,1, 1 ,1 ,1 ,1, 1 ,1 ,1 ,1, 1 ,1 ,1 ,1, 1 ,1 ,1 ,1, 1 ,1 ,1 ,1, 1 ,1 ,1 ,1, 1 ,1 ,1 ,1" },
        { "row": "1 ,1 ,1 ,1, 1 ,1 ,1 ,1, 1 ,1 ,1 ,1, 1 ,1 ,1 ,1, 1 ,1 ,1 ,1, 1 ,1 ,1 ,1, 1 ,1 ,1 ,1, 1 ,1 ,1 ,1" },
        { "row": "1 ,1 ,1 ,1, 1 ,1 ,1 ,1, 1 ,1 ,1 ,1, 1 ,1 ,1 ,1, 1 ,1 ,1 ,1, 1 ,1 ,1 ,1, 1 ,1 ,1 ,1, 1 ,1 ,1 ,1" },
        { "row": "1 ,1 ,1 ,1, 1 ,1 ,1 ,1, 1 ,1 ,1 ,1, 1 ,1 ,1 ,1, 1 ,1 ,1 ,1, 1 ,1 ,1 ,1, 1 ,1 ,1 ,1, 1 ,1 ,1 ,1" },
        { "row": "1 ,1 ,1 ,1, 1 ,1 ,1 ,1, 1 ,1 ,1 ,1, 1 ,1 ,1 ,1, 1 ,1 ,1 ,1, 1 ,1 ,1 ,1, 1 ,1 ,1 ,1, 1 ,1 ,1 ,1" },
        { "row": "1 ,1 ,1 ,1, 1 ,1 ,1 ,1, 1 ,1 ,1 ,1, 1 ,1 ,1 ,1, 1 ,1 ,1 ,1, 1 ,1 ,1 ,1, 1 ,1 ,1 ,1, 1 ,1 ,1 ,1" },
        { "row": "1 ,1 ,1 ,1, 1 ,1 ,1 ,1, 1 ,1 ,1 ,1, 1 ,1 ,1 ,1, 1 ,1 ,1 ,1, 1 ,1 ,1 ,1, 1 ,1 ,1 ,1, 1 ,1 ,1 ,1" },
        { "row": "1 ,1 ,1 ,1, 1 ,1 ,1 ,1, 1 ,1 ,1 ,1, 1 ,1 ,1 ,1, 1 ,1 ,1 ,1, 1 ,1 ,1 ,1, 1 ,1 ,1 ,1, 1 ,1 ,1 ,1" }
    ],
    "objectsMap": [
        { "row": "0 ,0 ,0 ,0, 0 ,0 ,0 ,0, 0 ,0 ,0 ,0, 0 ,0 ,0 ,0, 0 ,0 ,0 ,0, 0 ,0 ,0 ,0, 0 ,0 ,0 ,0, 0 ,0 ,0 ,0" },
        { "row": "0 ,0 ,0 ,0, 0 ,0 ,0 ,0, 0 ,0 ,0 ,0, 0 ,0 ,0 ,0, 0 ,0 ,0 ,0, 0 ,0 ,0 ,0, 0 ,0 ,0 ,0, 0 ,0 ,0 ,0" },
        { "row": "0 ,0 ,0 ,0, 0 ,0 ,0 ,3, 0 ,0 ,0 ,0, 0 ,0 ,0 ,0, 0 ,0 ,0 ,0, 0 ,0 ,0 ,0, 0 ,0 ,0 ,0, 0 ,0 ,0 ,0" },
        { "row": "0 ,0 ,0 ,0, 0 ,0 ,0 ,0, 0 ,0 ,0 ,0, 0 ,0 ,0 ,0, 0 ,0 ,0 ,0, 0 ,0 ,0 ,0, 0 ,0 ,0 ,0, 2 ,0 ,0 ,0" },
        { "row": "0 ,0 ,3 ,0, 0 ,0 ,0 ,0, 0 ,0 ,0 ,0, 0 ,0 ,0 ,0, 4 ,0 ,0 ,0, 0 ,0 ,0 ,0, 0 ,0 ,0 ,0, 0 ,0 ,0 ,0" },
        { "row": "0 ,0 ,0 ,0, 0 ,0 ,0 ,0, 0 ,0 ,4 ,0, 0 ,0 ,0 ,0, 0 ,0 ,0 ,0, 0 ,0 ,0 ,0, 0 ,0 ,0 ,0, 0 ,0 ,0 ,0" },
        { "row": "0 ,0 ,0 ,0, 1 ,0 ,0 ,0, 0 ,0 ,0 ,0, 0 ,0 ,4 ,0, 0 ,0 ,0 ,0, 0 ,0 ,0 ,0, 0 ,0 ,0 ,0, 0 ,0 ,0 ,0" },
        { "row": "0 ,0 ,0 ,0, 0 ,0 ,0 ,0, 0 ,4 ,0 ,0, 0 ,0 ,0 ,0, 0 ,0 ,0 ,0, 0 ,0 ,0 ,0, 0 ,0 ,0 ,0, 0 ,0 ,0 ,0" },
        { "row": "0 ,0 ,0 ,0, 0 ,0 ,2 ,0, 0 ,0 ,5 ,0, 0 ,0 ,0 ,0, 0 ,0 ,0 ,0, 0 ,0 ,3 ,0, 0 ,0 ,0 ,0, 0 ,0 ,0 ,0" },
        { "row": "0 ,0 ,3 ,0, 0 ,0 ,0 ,0, 0 ,0 ,0 ,2, 0 ,0 ,0 ,0, 0 ,0 ,0 ,0, 0 ,0 ,0 ,0, 0 ,0 ,0 ,0, 0 ,0 ,0 ,0" },
        { "row": "0 ,0 ,0 ,0, 0 ,0 ,0 ,0, 0 ,0 ,0 ,0, 0 ,0 ,0 ,0, 0 ,3 ,0 ,0, 0 ,0 ,0 ,0, 0 ,0 ,0 ,0, 0 ,0 ,0 ,0" },
        { "row": "0 ,3 ,0 ,0, 0 ,0 ,0 ,0, 0 ,0 ,0 ,0, 0 ,0 ,3 ,0, 0 ,0 ,0 ,0, 0 ,0 ,0 ,0, 5 ,0 ,0 ,0, 0 ,0 ,0 ,0" },
        { "row": "0 ,0 ,0 ,0, 0 ,1 ,0 ,0, 0 ,0 ,0 ,0, 0 ,0 ,0 ,0, 0 ,0 ,0 ,0, 0 ,0 ,0 ,0, 0 ,0 ,0 ,0, 0 ,0 ,0 ,0" },
        { "row": "0 ,0 ,0 ,0, 0 ,0 ,0 ,0, 0 ,0 ,0 ,2, 0 ,1 ,0 ,0, 0 ,0 ,0 ,0, 0 ,4 ,0 ,0, 0 ,0 ,0 ,0, 0 ,0 ,0 ,0" },
        { "row": "0 ,0 ,0 ,0, 0 ,0 ,2 ,0, 0 ,0 ,0 ,0, 3 ,0 ,0 ,0, 0 ,0 ,0 ,0, 0 ,0 ,3 ,0, 0 ,0 ,0 ,0, 0 ,0 ,0 ,0" },
        { "row": "0 ,0 ,3 ,0, 0 ,0 ,0 ,2, 0 ,0 ,0 ,0, 0 ,0 ,0 ,0, 0 ,0 ,0 ,0, 0 ,0 ,0 ,0, 0 ,0 ,0 ,0, 0 ,0 ,0 ,0" },
        { "row": "0 ,0 ,0 ,0, 0 ,0 ,0 ,0, 0 ,0 ,0 ,0, 0 ,0 ,0 ,0, 0 ,0 ,0 ,0, 0 ,0 ,0 ,0, 0 ,0 ,0 ,0, 0 ,0 ,5 ,0" },
        { "row": "3 ,0 ,0 ,3, 0 ,0 ,0 ,0, 0 ,1 ,0 ,0, 0 ,0 ,0 ,0, 0 ,0 ,0 ,0, 0 ,0 ,0 ,0, 0 ,0 ,0 ,0, 0 ,0 ,0 ,0" },
        { "row": "0 ,0 ,0 ,0, 0 ,0 ,0 ,0, 0 ,0 ,2 ,0, 0 ,0 ,0 ,0, 0 ,0 ,0 ,0, 0 ,0 ,0 ,0, 0 ,0 ,0 ,0, 0 ,0 ,0 ,0" },
        { "row": "1 ,0 ,2 ,0, 0 ,0 ,0 ,0, 0 ,0 ,0 ,3, 0 ,0 ,0 ,0, 0 ,0 ,0 ,0, 0 ,0 ,1 ,0, 0 ,0 ,0 ,0, 4 ,0 ,0 ,0" },
        { "row": "0 ,0 ,0 ,0, 0 ,0 ,0 ,0, 0 ,0 ,0 ,0, 2 ,0 ,0 ,0, 0 ,0 ,0 ,0, 0 ,0 ,0 ,0, 0 ,0 ,0 ,0, 0 ,0 ,0 ,0" },
        { "row": "0 ,0 ,0 ,0, 0 ,0 ,0 ,0, 0 ,0 ,0 ,0, 0 ,4 ,0 ,0, 0 ,0 ,0 ,0, 0 ,0 ,0 ,0, 0 ,0 ,2 ,0, 0 ,0 ,0 ,2" },
        { "row": "0 ,0 ,0 ,0, 0 ,0 ,0 ,0, 0 ,0 ,0 ,0, 0 ,0 ,5 ,0, 0 ,0 ,0 ,0, 0 ,0 ,0 ,0, 3 ,0 ,0 ,0, 0 ,0 ,0 ,0" },
        { "row": "0 ,0 ,0 ,0, 0 ,0 ,4 ,0, 0 ,0 ,0 ,0, 0 ,0 ,0 ,2, 0 ,0 ,0 ,0, 0 ,0 ,0 ,0, 0 ,0 ,0 ,0, 0 ,0 ,0 ,0" },
        { "row": "0 ,0 ,0 ,0, 0 ,0 ,0 ,0, 0 ,0 ,0 ,0, 0 ,0 ,0 ,0, 3 ,0 ,0 ,0, 0 ,0 ,0 ,0, 0 ,0 ,0 ,0, 0 ,0 ,1 ,0" },
        { "row": "0 ,0 ,0 ,0, 0 ,0 ,0 ,0, 0 ,0 ,0 ,0, 0 ,0 ,0 ,0, 0 ,2 ,0 ,0, 0 ,0 ,0 ,0, 0 ,0 ,0 ,0, 0 ,0 ,3 ,1" },
        { "row": "0 ,0 ,0 ,0, 0 ,0 ,0 ,0, 0 ,0 ,3 ,0, 0 ,0 ,0 ,0, 0 ,0 ,1 ,0, 0 ,0 ,0 ,0, 0 ,0 ,0 ,0, 0 ,0 ,1 ,1" },
        { "row": "0 ,0 ,0 ,0, 0 ,0 ,0 ,0, 0 ,0 ,0 ,0, 0 ,0 ,0 ,0, 0 ,0 ,0 ,4, 0 ,0 ,0 ,0, 0 ,0 ,0 ,0, 0 ,0 ,0 ,0" },
        { "row": "0 ,0 ,0 ,0, 0 ,0 ,0 ,0, 0 ,0 ,0 ,0, 0 ,0 ,0 ,3, 0 ,0 ,0 ,0, 3 ,0 ,0 ,0, 0 ,0 ,0 ,0, 0 ,0 ,0 ,0" },
        { "row": "0 ,0 ,0 ,0, 0 ,0 ,0 ,0, 0 ,0 ,0 ,0, 0 ,5 ,0 ,0, 0 ,0 ,0 ,0, 0 ,2 ,0 ,0, 0 ,0 ,0 ,0, 0 ,0 ,0 ,0" },
        { "row": "0 ,0 ,0 ,0, 0 ,0 ,0 ,0, 0 ,0 ,0 ,0, 0 ,0 ,0 ,0, 0 ,0 ,0 ,0, 0 ,0 ,1 ,0, 0 ,0 ,0 ,0, 0 ,0 ,0 ,0" },
        { "row": "0 ,0 ,0 ,0, 0 ,0 ,0 ,0, 0 ,0 ,0 ,0, 0 ,0 ,0 ,0, 0 ,0 ,0 ,0, 0 ,0 ,0 ,4, 0 ,0 ,0 ,0, 0 ,0 ,0 ,0" },
        { "row": "0 ,0 ,0 ,0, 0 ,0 ,0 ,0, 0 ,0 ,0 ,0, 0 ,0 ,0 ,0, 0 ,0 ,0 ,0, 0 ,0 ,0 ,0, 5 ,0 ,0 ,0, 0 ,0 ,0 ,0" },
        { "row": "0 ,0 ,0 ,0, 0 ,4 ,0 ,0, 0 ,0 ,0 ,0, 0 ,0 ,0 ,0, 0 ,0 ,0 ,0, 0 ,0 ,0 ,0, 0 ,3 ,0 ,0, 0 ,0 ,0 ,0" },
        { "row": "0 ,0 ,0 ,0, 0 ,0 ,0 ,0, 0 ,3 ,0 ,0, 0 ,0 ,0 ,0, 0 ,0 ,0 ,0, 0 ,0 ,0 ,0, 0 ,0 ,3 ,0, 0 ,0 ,0 ,0" },
        { "row": "0 ,2 ,0 ,0, 0 ,0 ,0 ,0, 0 ,0 ,0 ,0, 0 ,0 ,0 ,0, 0 ,0 ,0 ,0, 0 ,0 ,0 ,0, 0 ,0 ,0 ,1, 0 ,0 ,0 ,0" },
        { "row": "0 ,0 ,3 ,0, 0 ,0 ,0 ,0, 0 ,0 ,0 ,0, 0 ,0 ,0 ,0, 0 ,0 ,0 ,0, 0 ,0 ,0 ,0, 0 ,0 ,0 ,0, 0 ,0 ,0 ,0" },
        { "row": "0 ,0 ,0 ,0, 0 ,0 ,0 ,0, 0 ,0 ,0 ,0, 0 ,0 ,0 ,0, 0 ,3 ,0 ,0, 0 ,0 ,0 ,2, 0 ,0 ,0 ,0, 0 ,2 ,0 ,0" },
        { "row": "0 ,0 ,0 ,0, 0 ,0 ,0 ,0, 0 ,0 ,0 ,0, 0 ,0 ,0 ,0, 0 ,0 ,0 ,5, 0 ,0 ,0 ,0, 0 ,0 ,0 ,0, 0 ,0 ,5 ,0" },
        { "row": "0 ,0 ,0 ,0, 0 ,0 ,0 ,0, 0 ,0 ,0 ,0, 0 ,0 ,0 ,0, 0 ,0 ,0 ,0, 0 ,0 ,0 ,0, 0 ,0 ,0 ,0, 0 ,0 ,0 ,0" }
    ]
}